87 87 87 87 87 87 87 87 87 87 87 87 87 87 87 
87 46 46 46 46 46 46 46 46 46 46 46 46 46 87 
87 46 46 46 46 46 46 46 46 46 46 46 46 46 87 
87 46 46 46 46 46 46 46 46 46 46 46 46 46 87 
87 46 46 46 46 46 46 46 46 46 46 46 46 46 87 
87 46 46 46 87 87 87 87 87 87 46 46 46 46 87 
87 46 46 46 87 46 46 46 46 87 46 46 46 46 87 
87 46 46 46 87 46 46 46 46 87 46 46 46 46 87 
87 46 46 46 87 87 87 87 87 87 46 46 46 46 87 
87 46 46 46 46 46 46 46 46 46 46 46 46 46 87 
87 46 46 46 46 46 46 46 46 46 46 46 46 46 87 
87 46 46 46 46 46 46 46 46 46 46 46 46 46 87 
87 87 87 87 87 87 87 87 87 87 87 87 87 87 87 
